135 151
###########################################################################.###########################################################################
#.....#...#.......#...........#.....#.......#.....#.....#.......#.........#...#.....#.......#.....#...#...................#.........#...#.............#
#.#.#.###.#.#.###.###.#.#######.#.#.#.#.#####.###.#.#.#.#.#####.#.#.#####.#.###.###.###.###.#.#.#.#.#.#.#################.#.###.#####.#.#.###########.#
#.#.#.#...#.#...#...#.#...#.....#.#.#.#.....#.#.#...#.#...#.....#.#...#...#.#...#.#...#.#...#.#.#.#.#.#.......#.....#.....#.#...#.....#.....#.......#.#
#.#.#.#.#.#.###.###.#####.#.#####.#.#.#####.#.#.#####.#####.#####.###.#.###.###.#.###.###.###.#.#.#.#.#######.#.###.###.###.#####.###########.#####.#.#
#.#.#...#.#...#.#.......#.......#.#.#...#.#.....#.....#...#.#.......#.#...#.#...#...#...#.#...#.#...#.......#.#...#...#.#.#.........#.......#.#...#...#
###.#.#######.#.#######.#########.#####.#.#######.#######.#.#######.#.###.#.#.###.#.###.#.#.###.###########.#.###.###.#.#.#.#####.###.#####.#.#.#####.#
#...#.#.......#.....#...#...#.....#.......#...#...#.....#.#.....#...#.#...#...#...#.#...#.....#...#...#...#.#.#...#...#.#...#...#.#...#...#...#.....#.#
#.#####.###########.#.###.#.#.#####.#######.#.#.###.#.#.#.#####.#####.#############.#.###########.#.#.#.#.#.#.#.###.###.#####.#.###.###.#######.###.#.#
#.....#.....#.#...#.#.....#...#.......#...#.#.#...#.#.#.....#.#.....#.........#...#.#...#.....#...#.#...#.#.#.#.#...#.#.#...#.#...#...#.........#...#.#
#.###.#####.#.#.#.#.###########.#######.#.#.#.#.#.###.#####.#.#####.#######.#.#.#.#.###.#.###.#.###.#####.#.#.#.#.###.#.#.#.#.###.###.#.#########.###.#
#.#.....#...#...#.#.#...............#...#...#.#.#...#.....#.......#.#.......#.#.#.....#.#.#.#...#.....#...#.#.#.#.#.....#.#...#.......#.#.......#.....#
#.#.#####.###.###.#.#.###############.#######.#####.#####.###.#####.#.#######.#.#####.#.#.#.#####.###.#####.#.#.#.###.###.###.#########.###.###.#######
#.#.....#...#...#.#.#...#.....#.......#...#.#.......#.....#...#...#.#.....#.....#...#.#...#.....#...#...#...#...#...#...#...#.#.....#.......#.#.......#
#.#####.###.#.###.#.###.#####.#.#.#####.#.#.#########.#########.#.#.#####.#######.###.#######.###.#####.#.###.#####.###.###.###.###.#########.#.#######
#.#.....#...#.#...#...#.#.....#.#.#.....#.#...#.....#.#.....#...#.#.....#.#.....#...........#.....#.....#.#.......#.#.#...#.......#.#.....#.....#.....#
###.###.#.#####.#.#.#.#.#.#####.###.#####.#.#.#.###.#.#.###.#.###.#####.#.#.###.###########.#######.#####.#########.#.###.#########.#.###.#######.###.#
#...#...#.....#.#.#.#.#.#.....#...#.....#.#.#...#...#.#...#...#.#...#...#.....#.#...#...#.......#...#...#...#.......#...#.........#.#.#...#.......#...#
#.###########.#.###.#.#.#####.###.###.###.#.#.#####.#.###.#####.###.#.###.#####.#.#.#.#.#######.#.#.#.#.###.#.#######.###########.#.#.#.###.#######.#.#
#...........#.#.#...#.#.#.......#.....#...#.#.#...#...#...#.....#...#.#.#...#...#.#...#.....#.....#.#.#.....#.......#.......#.#...#.#.#...#.......#.#.#
#.#########.#.#.#.#####.#.#######.#####.###.#.#.#.#####.#######.#.###.#.###.#.#.#.#########.#.#######.#######.#####.#.#.###.#.#.###.#.###.#######.#.#.#
#.#.......#.....#.........#.....#...#...#...#.#.#...#...#.......#...#.#.....#.#.#...#.....#.#...#.....#.....#...#...#.#...#...#.#...#.#.#.......#.#.#.#
#.#.#############.#########.###.#####.###.###.#.###.#.#####.###.###.#.#######.#.###.#.#####.#####.#######.#.#####.#####.#.#.###.#.#.#.#.#######.#.#.#.#
#...#.....#.....#...#...#...#.......#...#...#.#...#.#.......#.#...#.#...#...#.#...#.#.....#.#...#.#.......#...#...#...#.#.#.#.....#.#...#.#...#...#.#.#
###.#.###.#.###.#####.#.#.#########.#.#.###.###.###.#########.###.#.###.#.#.#.#####.#####.#.#.#.#.#.#########.#.#.#.#.#.#.###.#########.#.#.#.#####.#.#
#.#.#.#...#.#.......#.#.#.....#.#...#.#...#.....#...#.....#...#...#.....#.#...#.....#.....#.#.#.#.#...#...#...#.#.#.#.#.#.......#...#...#.#.#.......#.#
#.#.#.#.###.#######.#.#.#####.#.#.###.###.#.#####.#.###.#.#.#.#.#########.#####.#####.###.#.#.#.#.###.###.#.###.###.#.###########.#.#.###.#.#########.#
#...#.#.....#...#.....#.......#...#.....#.#...#...#.....#...#.#.#...#...#.....#.......#...#...#.#...#...#.#...#.#...#.......#.....#...#...#.#.....#.#.#
#.###.#####.#.#.#.#############.#######.#.###.#.#############.#.#.#.#.#.#.###.#########.#######.###.###.#.###.#.#.#########.#.#########.###.#.###.#.#.#
#.#...#...#.#.#.#...#.....#...#.......#.#.#.#.#.....#.......#.#.#.#.#.#...#...#.......#.......#...#.....#.#...#...#.......#.....#.....#...#.#.#...#...#
#.#.###.#.#.#.#.#####.###.#.#.#######.###.#.#.#####.#.###.###.#.###.#.#####.#.#.###.#########.###.#######.#.#####.#.###.#######.#.###.#.#.#.#.#.###.###
#.#.#...#.#.#.#.#...#.#...#.#...#...#.....#.#.#.....#.#.#.....#.#...#...#...#.#.#.#.....#.....#...........#.#...#...#...#.....#...#...#.#.#...#...#.#.#
#.#.#.###.#.#.#.#.#.#.#.#.#.###.###.#######.#.#.#####.#.#######.#.#.###.#.#####.#.###.#.#.#####.###########.#.#.#####.###.###.#####.#####.#######.#.#.#
#.#.#.#.#.#.#.#...#...#.#.#...#...#...#.......#.#...#.....#.....#.#...#.#.....#.....#.#.#.#...#.#.....#.....#.#.#...#...#...#.....#.........#.#...#...#
#.#.#.#.#.###.#########.#.#.#####.#.###.#######.#.#######.#.#####.#####.#####.#####.#.###.#.#.#.#.###.#.#####.#.#.#.#.#####.#####.#########.#.#.#######
#.#.#.#.#.....#.....#...#.#.#.....#...#.#.#...#.#.......#.#...#.#.....#.....#.......#.......#.#.#.#.#.#.......#.#.#.#.#.....#...#.....#...#...#.......#
#.#.#.#.#########.#.#.#####.#.#######.#.#.#.#.#.#.###.#.#.###.#.#.###.###.#########.###########.#.#.#.#########.#.#.#.#.#####.#.#####.#.#.###########.#
#.#.#...#.....#...#.#.#...#.#.......#.#.#.#.#...#...#.#.#.#.#.#.....#...#.#.......#.......#.....#...#.......#.#...#.#.#...#...#...#...#.#.....#.....#.#
#.#.###.#.###.#.###.#.#.#.#.#######.#.#.#.#.#####.###.###.#.#.#######.#.#.#.#####.#.#####.#.###.###.###.###.#.#####.#####.#.#####.#.###.#####.#.###.#.#
#.#...#.#.#.....#.#.#...#...#.....#.#.....#.#...#.#...#...#.#.......#.#...#.#...#.#.#...#.#.#.....#.#...#.......#.#.#.....#.....#.#.#...#...#...#.#.#.#
#.#.###.#.#######.#.#########.###.#.#####.#.#.#.#.#.###.###.#######.#.#####.#.#.#.###.#.###.#.#####.#.#########.#.#.#.###########.#.#.#.###.#####.#.#.#
#.#...#.#.......#...#.#.......#...#...#...#.#.#.#.#.............#...#.#.#...#.#.#.#...#.....#.#.....#...#...#.#...#.#.#...#.......#.#.#...#...#.......#
#.###.#.#.#####.#.###.#.#.#####.#####.#####.#.#.#.###############.###.#.#.#####.#.#.#####.#####.#######.#.#.#.###.#.#.#.#.#.#######.#####.#.#.#.#######
#...#...#.#...#.#...#...#.#.#...#...#.#.....#.#.#.#...............#.....#.#.....#...#...#.#...#.......#...#.#.....#.#.#.#.#...#...#.#.....#.#.#...#...#
###.#####.###.#.###.#####.#.#.###.#.#.#.###.#.#.###.###################.#.#.#.#.#.###.#.###.#.#######.#####.#.#####.#.#.#.###.#.#.#.#.#####.#####.#.#.#
#.#.#.........#...#.#.....#.#...#.#.#.#...#.#.#...#...#.......#...#...#.#.#.#.#.#.#...#.....#...#.......#...#...#.#...#.#...#.#.#...#.#.#.........#.#.#
#.#.#####.#######.#.#.#####.###.#.###.#.#.###.###.###.#.#####.#.#.#.#.###.###.#.#.#.#########.#.#.#######.#####.#.#####.###.#.#.#####.#.#.#########.#.#
#.#.....#.#.......#...#.#.....#.#...#.#.#.......#...#.#.#...#.#.#...#.....#...#.#.#.#.#.......#.#.#.#.....#...#.#.........#.#.#.....#.#.....#...#.#.#.#
#.#####.###.###########.#.###.#.###.#.###.#########.#.#.#.###.#.###########.#####.#.#.#.#######.#.#.#.#####.#.#.#####.###.#.#.#####.#.#####.#.#.#.#.#.#
#.....#...#...#.........#...#...#...#...#.....#...#.#.#.#.#...#...........#.#.....#.#.#.#.......#...#.#...#.#.#.....#.#...#...#...#.#...#.....#...#.#.#
#.#.#.###.###.#.#######.###.#####.#.###.###.###.#.#.#.#.#.#.###.#########.#.#.#####.#.#.#########.###.#.###.#.#####.###.#####.#.###.#.#.#####.#####.#.#
#.#.#...#.....#.....#.....#...#...#...#.#...#...#...#...#.#.#.......#.....#.....#.....#.#.......#.#...#.#...#...#.#...#...#...#.#...#.#.....#.#...#.#.#
#.#.###########.###.###.#####.#.#####.#.#####.#####.#####.#.#######.#.###########.#####.#.#####.#.#.###.#.###.#.#.###.###.#.###.#.#####.###.###.#.#.#.#
#.#.#...#...#...#.#...#.#...#...#.....#.#...#.#.#...#.....#.....#...#...#.........#.#...#.....#...#...#.#...#.#.#...#.#...#.#...#.....#...#.....#...#.#
#.#.#.#.#.#.#.###.###.###.#.###.#######.#.#.#.#.#.###.###.#####.#.#####.#.#########.#.#######.#######.#.#.###.#.###.#.#.###.#.#######.###############.#
#.#.#.#...#.#...#...#.#...#.....#.....#...#.#.#.#...#...#...#...#.....#.............#.......#.......#.#...#...#.....#...#.#.#.......#.#...#...........#
#.#.#.#####.###.#.#.#.#.#########.###.#####.#.#.###.#####.###.#######.#############.###.###.#######.#.#####.#######.#####.#.#######.#.#.#.#.#########.#
#.#...#...#.#...#.#.#...#.....#...#.....#...#.#.#...#.....#...#.....#.#.......#...#.#.#...#.#.....#.#.....#.......#...#.....#...#...#.#.#.#.#.......#.#
#.#####.#.#.#.###.###########.#.#######.#.###.#.#.###.###.#.###.#.#.###.#####.#.###.#.###.#.#####.#.#####.#######.#####.#####.#.#.###.#.#.#.###.###.#.#
#.#.....#.#...#.............#.#.....#.....#...#.#.#...#...#.#...#.#.....#.....#.........#.#.#...#.#.#...#.......#.......#...#.#.#...#.#.#.#...#...#.#.#
#.#.#.#######.#####.#######.#.#####.#######.###.#.#.#######.#####.#######.#####.#######.#.#.#.#.#.#.###.#####.#.#.#######.#.#.#.###.#.#.#.###.#.#.###.#
#...#.#.....#.....#...#.....#.....#.....#...#.......#.......#.....#...#...#.......#...#.#.#...#...#...#.#...#.#.#.........#...#.....#.#.#...#.#.#.#...#
###.###.###.#####.###.#####.###.#.#####.#.#########.#.#######.###.#.#.#.###########.#.###.#######.###.#.#.#.###.#############.#######.#.###.#.#.#.#.###
#...#...#.#.#...#...#.....#.....#.....#.#.........#.#...#.....#...#.#.#.....#.......#...#.#...#.....#...#.#...#.........#...#.#...#...#.#...#.#.#...#.#
#.###.###.#.#.#.###.#.###.#######.#####.#.#######.#.###.#.###.#####.#.#####.#.#########.#.#.#.#.#######.#.###.#########.#.#.###.#.#.###.#.###.#.#####.#
#...#.#...#.#.#...#.#...#.....#...#.....#...#.#...#.#...#.#...#.....#.#...#...#.....#...#...#.#...#.....#.#...........#...#...#.#...#...#...#.#.....#.#
#####.#.#.#.#.#.###.###.#####.#.###.#######.#.#.###.#.###.#.###.#####.#.#.#####.#####.###.###.###.#.#####.###########.#######.#.#######.###.#.#####.#.#
#...#.#.#.#.#.#.....#.#.#...#.#...#.....#.....#.#...#.#...#.....#.....#.#.......#...#...#...#...#.#.....#.#.........#.#.....#.#.#.......#.#.#.#...#...#
#.#.#.#.#.#.#.#######.#.#.###.###.#####.#####.#.#.###.###########.#####.#####.#.#.#.###.#######.#.#####.#.#.#######.#.#.###.#.#.#.#######.#.#.#.#.###.#
#.#.#.#.#...#.#.........#...#.#...#...#.#...#.#.#.#...#...#.......#...#.#.....#.#.#.............#.....#.#.......#...#.#...#...#.#...#...#.#.#...#.#...#
#.#.#.#.#####.#####.#######.#.###.###.#.#.#.#.#.###.###.#.#.#######.#.###.#######.#####################.#########.###.###.#####.#.#.#.#.#.#.#####.#.###
#.#...#.#...#.....#.........#...#.#...#...#.#.#...#.#...#...#.#.....#.....#...#.....#.....#.........#.....#...#...#.#.#...#.....#.#.#.#.#...#.....#...#
#.#####.#.#.#####.###.#########.#.#.#.#####.#####.#.#.#######.#.#.###.#####.#.#.#####.###.#.#######.#.#####.#.#.###.#.#.#.#.#####.#.#.#.#.###.#######.#
#.....#.#.#.....#...#.#...#.....#...#.#...#.....#...#.....#.....#...#.#.....#...#.....#.#...#.....#.....#...#...#.#.....#.#.#.....#...#.#...#.......#.#
#.###.#.#.#####.###.###.#.#.#.#######.#.#.#####.#.#####.#.#####.###.###.#########.#####.#####.#.#########.#######.#.#######.#######.###.###.#######.#.#
#...#.#...#.#...#.#.#...#...#.#...#...#.#.....#.#.....#.#.....#...#.....#...#...#...#.........#.#.......#.......#.#.#.#...#.#.....#.#...#.#.........#.#
###.#.#####.#.###.#.#.###.#####.#.#.###.#####.#.#####.###.###.###.#######.#.#.#.###.#########.###.#####.#######.#.#.#.#.#.#.#.###.###.###.###########.#
#.#.#...#...#...#.....#...#.....#.#.#...#.....#.#...#...#...#.#.#.#...#...#...#.............#.#...#...#.......#.#.....#.#.#...#.#.....#...#.........#.#
#.#.###.#.#.###.###########.#####.#.#####.###.#.#.#.###.###.#.#.#.###.#.###################.#.#.###.#########.#.#######.#.#####.#######.###.#.#######.#
#.....#.#.#.....#...........#...#.#.......#...#.#.#.......#.#.#.......#...#.........#.....#...#.#.........#...#.........#...#.......#.....#.#.........#
#######.#.#######.###########.###.#.#######.###.#########.###.#####.#####.#.#######.#.###.###.#.#.#####.###.###########.###.#.#####.#.###.#.###########
#.......#.....#.......#.#.....#...#.#...#.#.#...#.....#.....#.....#.#...#.#.#...#...#...#.....#.#...#...#...#...#.....#...#.#...#...#.#.#...#.#.......#
#.###########.###.###.#.#.###.#.#####.#.#.#.#.###.###.#####.#####.###.#.#.#.#.#.#.#######.#####.###.#.###.###.#.#.###.#####.###.#.###.#.#####.#.#####.#
#...#.....#.#...#...#.#.....#.........#.#.#.#...#...#...#.#.#.....#...#...#.#.#.#.#.....#.#.....#...#...#.....#.#...#...#.....#.#...#.......#.......#.#
###.###.#.#.###.#####.#################.#.#.###.###.###.#.#.#.###.#.#####.#.#.#.#.#.###.###.#########.#.#######.#.#.###.#.#####.###.#######.#########.#
#...#...#.....#.#...#.....#...#...#.....#...#.#...#.#...#.....#...#.#...#.#.#.#.#...#.#.....#.......#.#.......#.#.#.#.#.#.....#.#.#.......#.#...#...#.#
#.###.#########.#.#.#.###.#.#.#.###.#####.###.#.###.#.###.#########.#.#.###.#.#######.#########.###.###.#.#####.#.#.#.#.#.###.#.#.#######.#.#.#.#.#.#.#
#.#.......#...#...#.#...#...#.#...#.#...#.#...#.....#...#...#.......#.#.....#.......#...#.......#.#...#.#...#...#.#.#...#.#...#...#.#...#.#...#...#.#.#
#.#.#####.#.#.#####.###.#####.###.#.#.###.###.#########.###.#.#######.###########.#.###.#.#.#####.###.#####.#.#####.#.###.#.#.###.#.#.#.#.#########.#.#
#.#.#...#...#.#...#.#.......#...#...#...#...........#...#...#.#.....#.......#...#.#...#.#.#...#.....#.#.....#.#.....#.#...#.#.#...#...#.#.........#...#
#.#.###.#####.#.#.#.###########.#.#####.###########.#.#######.#.#.#.#######.#.#.#.###.#.#.###.#####.#.#.###.#.###.###.#####.###.#######.#######.#####.#
#.#.#.......#.#.#.#...#.........#...#.....#...#.....#.#...#...#.#.#.#...#...#.#.#.#.#...#.#.#.....#.....#...#.....#.#.......#...#...#...#.....#.#.....#
#.#.#.#.#####.#.#.###.#.###########.#.###.#.#.#.#####.#.#.#.#####.#.###.#.###.#.#.#.###.#.#.#####.#################.#######.#.###.#.#.#.#####.#.#.#####
#.#...#.#...#...#...#.#.#.....#.#...#...#.#.#.#.#...#...#...#...#.#.....#...#.#...#.....#.#.....#...................#.......#.#...#.#.#...#...#...#...#
#.#####.#.#.#####.#.#.#.#.###.#.#.#####.#.#.#.#.#.#.#########.#.#.#######.#.#.#####.#####.###.###############.#######.#######.#.#.#.#.###.#.#.#####.#.#
#.....#.#.#.......#.#.#.....#.#...#...#.#.#.#...#.#...#.....#.#...#.....#.#.#.#.#...#.....#...#...........#.#.........#...#...#.#.#...#.#...#.......#.#
#.###.###.#####.#####.#.#####.#.###.#.#.###.#####.###.#.###.#.###.#.###.###.#.#.#.###.#####.###.#######.#.#.###########.#.#.#####.#####.#############.#
#...#.#...#...#.#.....#.#...#.#.....#.#...........#.#...#...#.#...#.#.#...#.#.#.....#.....#.....#.....#.#.#.#.....#.....#.#.....#...#.#...#.....#...#.#
#####.#.###.#.#.#.#######.#.#.#######.#############.#####.###.#####.#.###.#.#.###.#######.#.#####.###.#.#.#.#.###.#.#####.#####.###.#.#.#.#.###.#.#.#.#
#.....#...#.#...#.......#.#...#.....#.......#.............#...#.....#...#...#...#.#.....#.#...#.#...#.#.#.#.....#.......#.....#.....#...#...#...#.#...#
#.#####.#.#############.#.#####.#.#########.###########.#####.#.#####.#.#####.#.###.#.#.#.###.#.###.#.#.#.###############.#.#.#######.#######.#.#.#####
#.#.....#.............#...#.#...#.....#.....#.........#.......#.....#.#.#...#.#.....#.#.#.#...#...#.#.#.#.....#.........#.#.#...#...#.#.....#.#.#.#...#
#.#################.#######.#.#######.#.#####.#######.#######.#####.#.#.#.#.#.#######.###.#.#####.#.#.#.#####.#.#######.#.#.###.###.#.#####.#.###.#.###
#.#...........#.....#.......#.....#.#.#.#.....#.#.....#.....#.....#.#.#...#.#...#...#.....#.......#.#...#...#...#.......#.#.#.#.....#.......#.#...#...#
#.#.#########.#.#####.#.#.#######.#.#.#.#.#####.#.#####.###.#.#####.#.#####.###.#.#.#######.#####.#.#.###.#.#########.#####.#.#####.#######.#.#.#####.#
#.#...#.......#.#.....#.#.#.....#.#.#.#...#.....#...#.#...#.#.#...#.#...#.....#.#.#.......#.#...#.#.#.#...#.........#.......#.........#.....#...#.....#
#.###.#.#######.#.#####.###.#.#.#.#.#.#######.#####.#.#.#.###.#.#.#.#.#.#######.#.#######.#.#.#.###.###.###########.#########.#########.###########.#.#
#...#.#...#...#...#...#...#.#.#.#.#.#.....#...#.....#...#.....#.#.#.#.#.......#.#.#.#.....#.#.#...#...#...#...#...#.......#.#...#.......#...........#.#
###.#.###.#.#.#.###.#.###.#.#.###.#.#.###.#.#.#.#####.#########.#.#.#.#######.#.#.#.#.#####.#.###.###.###.#.#.#.#.#######.#.###.#.###########.#.#####.#
#...#...#.#.#.#.#...#...#.#.#.......#.#.#...#.#...#...#.........#...#.#...#...#...#...#...#.#...#.....#...#.#...#.....#...#.#...#.#.........#.#...#...#
#.#####.#.#.#.###.#####.#.#.#########.#.###.#####.#.###.#####.#######.#.#.#.#######.###.#.#.###.###.###.###.#####.#####.###.#.###.#.#.#####.#.###.#####
#.......#...#.....#...#.#.#.#.....#...#.....#...#.#.#...#...#.#.....#.#.#.#.....#...#...#.#...#.#...#...#...#.....#.....#...#.#.#.#.#.#.....#.#.#.....#
#.#################.#.#.#.#.###.#.#.###.#####.#.#.###.#####.#.#.###.###.#.#.#.###.###.###.#####.#####.#####.#.#####.#####.#.#.#.#.###.#.#####.#.#####.#
#.#...#.....#.#.....#...#.#...#.#.#.#...#.....#.......#...#...#.#.#.....#.#.#.........#.........#.....#.....#.#...#...#...#...#.#.....#.#.#...#.....#.#
#.#.#.#.###.#.#.#########.###.#.###.#####.#############.#.#####.#.#######.#.#####################.#####.#.###.###.###.#.#######.#######.#.#.###.#####.#
#.#.#.#.#.#.#.#.....#.....#...#...#.........#.....#...#.#.....#.#.....#...#.#...............#...#.....#.#.#.#...#...#.#.....#.......#...#.#...#.#...#.#
#.#.#.#.#.#.#.#####.#.#####.#####.###########.###.#.#.#.#####.#.###.#.#.###.#.#############.#.#.#####.#.#.#.###.###.#.#####.#####.###.###.###.#.#.#.#.#
#.#.#...#...#.....#.#.#.....#.....#.....#.....#.#...#...#...#.......#.#.#.#.#.#...........#...#...#...#.#.#.........#...#.........#...#.....#...#.#...#
#.#.#####.###.#.###.#.#.#####.#.#.###.#.#.#####.#########.#.###########.#.#.#.#.#######.#.#####.###.###.#.#########.###.#####.#####.###.#.#####.#.###.#
#.#...#.#.....#.#...#.#.#.....#.#...#.#.#.#...........#...#.............#...#.#...#...#.#...#...#...#...#.......#.....#.....#.#.....#...#.......#...#.#
#.#.#.#.#####.###.###.#.#######.###.###.#.#########.###.###############.#####.###.#.###.###.#.###.#########.###.#####.#####.###.#####.#############.###
#.#.#.#.....#.#...#...........#...#.....#.#.......#...#.......#.....#...#...#.#.....#...#...#.....#.......#...#.....#.#...#...#...#...#...#...#...#....
#.#.#.###.###.#.#.###########.###.#####.#.#.#####.###.#######.#.###.#.###.#.#.#.#####.###.#########.#####.#########.#.#.#.###.###.#.###.#.#.#.#.#.###.#
#.#.#...#...#.#.#.#...#...#.......#.....#.#...#.#.#.......#...#...#.#.#...#...#.#.....#.#.#...#.....#...#.#.....#...#...#...#...#.#.#...#.#.#.#.#...#.#
#.#.###.#.#.#.#.###.#.#.#.###############.###.#.#.#.#####.#.#####.#.#.#.#########.#####.#.#.#.###.###.###.#.###.#.#########.#.###.#.#.###.###.#.###.#.#
#.#.#...#.#...#.....#...#...........#...#...#.#...#.....#.#.....#.#...#.....#.....#.....#.#.#...#.#.....#...#...#...#.....#.#...#.#...#.......#.#...#.#
#.###.###.#########################.#.#.###.#.#.#####.#.#######.#####.#####.#.#####.#.###.#.###.#.###.#.#####.###.#.#####.#.###.#.###########.#.#.###.#
#.....#.#.......#.............#...#...#.#...#.#.#...#.#.......#.....#.....#.#.....#.#.....#.#.#.#...#.#.....#.#...#.#.....#...#.#.#.....#.....#.#...#.#
#######.#######.###.###.#####.#.#.#####.#.###.#.#.#.#.#####.#######.#######.#.###.#####.###.#.#.###.#.#####.#.###.#.#.#######.#.#.#.###.#.#####.###.#.#
#.#...........#...#.#...#...#...#.#.....#...#.#...#.#.#...#.......#.........#...#.....#...#.#.......#.#.....#...#.#.#.......#.#...#.#.#.#.#...#.#.#.#.#
#.#.#####.###.###.###.#####.#####.#.#######.#.#####.#.#.#####.###.###################.###.#.###########.#######.###.#.#####.#.#####.#.#.###.#.#.#.#.#.#
#.#.....#...#...#.....#.....#...#.#...#.....#.#...#.#...#...#...#.#.....#...........#.#...#.....#.......#.....#.....#.....#.#.......#...#...#.#.#...#.#
#.#####.###.###########.#####.#.#.###.#.#####.#.###.#####.#.###.#.#.###.###.#######.#.#.#######.#.#######.#.#############.#.#########.###.###.#.#.###.#
#.........#...................#.....#.........#...........#.....#...#.......#.........#.........#.........#...............#...............#.....#.....#
#######################################################################################################################################################
